

		  

1111111111111   
1P0000C0000E1 
1000000000001
1000000000001 	 	 	             
1111111111111





