1111111111111
1C10000000C11      
10000000P0011   
100011E000001
1111111101111
1111111101111
1C10000000C11      
1000011110011   
1C0011C000001
1111111111111