1111111111111
1C00000000C11      
10C0011110011   
1P0011E000001
1111111111111
