1111111111111
1110M00000111      
10000000P0011   
100011EC00001
1111111101111
1111111101111
1010000000111      
1000011110011   
1C0011100M001
1111111111111