1111111111111
1110000000111      
10000000P0011   
100011EC00001
1111111101111
1111111101111
1010000000111      
1000011110011   
1C00111000001
1111111111111