1111111111111
1110M00000111      
1000001000011   
110011E000001
1111111101111
1111111101111
1P00000000111      
1110011110011   
1C1011100M001
1111111111111
